.......###################....##########
.Y.....................................#
..................=====................#
...............................*.......#
.....====....*.....=====...............#
.......................................#
...............=========...............#
..............................*........#
................=======................#
.......................................#
.........====..........................#
.......................................#
............====.......................#
...................*.====..............#
..................====.................*
...........=====.......................#
......................................*#
.____________________________._________#
ROUTES