.......###################....##########
.Y.....................................#
..................=====................#
.......*...............................#
.....====....*.....=====...............#
.......................................#
...............=========...............#
..............................*........#
.........................=======.......#
.......................................#
............................====.......#
........................................
...........................====.........
...................*.====...............
..................====.................*
...........=====.......................#
......................................*#
.____________________________..________#