.......###################....##########
.Y.....................................#
..................=====................#
...............................*.......#
.....====....*.....=====...............#
.......................................#
...............=========...............#
..............................*........#
................=======................#
.......................................#
.........====...........................
........................................
............====........................
...................*.====..............
..................====.................#
...........=====.......................#
......................................*#
.____________________________._________#
ROUTES